madison_ruby
An Interactive Fiction by Chris Wilson
Release 1 / Serial number 120802 / Inform 7 build 6G60 (I6/v6.32 lib 6/12N) SD

Capitol Square West
You are standing on the Capitol Square in Madison. It is a sunny August morning. Madison Ruby is about to begin.

Ahead, to the west, is the bustling pedestrian mall of State Street. Towering behind you is the white-domed Capitol Building.

There is a helpful walking map.

>test me
(Testing.)

>[1] west

'State Street Entrance'
You are standing on the first block of State Street. The commotion of people beginning their day surrounds you.

>[2] east

Capitol Square West
You are standing on the Capitol Square in Madison. It is a sunny August morning. Madison Ruby is about to begin.

Ahead, to the west, is the bustling pedestrian mall of State Street. Towering behind you is the white-domed Capitol Building.

* * *

madison_ruby
An Interactive Fiction by Chris Wilson
Release 1 / Serial number 120802 / Inform 7 build 6G60 (I6/v6.32 lib 6/12N) SD

Capitol Square West
You are standing on the Capitol Square in Madison. It is a sunny August morning. Madison Ruby is about to begin.

Ahead, to the west, is the bustling pedestrian mall of State Street. Towering behind you is the white-domed Capitol Building.

There is a helpful walking map.

>l
Capitol Square West
You are standing on the Capitol Square in Madison. It is a sunny August morning. Ahead, to the west, is the bustling pedestrian mall of State Street. Towering behind you is the white-domed Capitol Building.

>w
'State Street Entrance'
You are standing on the first block of State Street. The commotion of people beginning their day surrounds you.

>l
'State Street Entrance'
You are standing on the first block of State Street. The commotion of people beginning their day surrounds you.

* * *

>l
Capitol Square West
You are standing on the Capitol Square in Madison. It is a sunny August morning. Ahead, to the west, is the bustling pedestrian mall of State Street. Towering behind you is the white-domed Capitol Building.

>look
Capitol Square
You are standing on the Capitol Square in Madison. It is a sunny August morning.

* * *

madison_ruby
An Interactive Fiction by Chris Wilson
Release 1 / Serial number 120802 / Inform 7 build 6G60 (I6/v6.32 lib 6/12N) SD

Capitol Square West
You are standing on the Capitol Square in Madison. It is a sunny August morning. Madison Ruby is about to begin.

Ahead, to the west, is the bustling pedestrian mall of State Street. Towering behind you is the white-domed Capitol Building.

There is a helpful walking map.

>take the Capitol
You can't see any such thing.

>take the Capitol Building
You can't see any such thing.

>look
Capitol Square
You are standing on the Capitol Square in Madison. It is a sunny August morning. Ahead, to the west, is the bustling pedestrian mall of State Street.

Towering behind you is the white-domed Capitol Building.

>go west
'State Street Entrance'
You are standing on the first block of State Street. The commotion of people beginning their day surrounds you.

>e
Capitol Square
You are standing on the Capitol Square in Madison. It is a sunny August morning. Ahead, to the west, is the bustling pedestrian mall of State Street.

Towering behind you is the white-domed Capitol Building.

>take building
Taken.

* * *

madison_ruby
An Interactive Fiction by Chris Wilson
Release 1 / Serial number 120802 / Inform 7 build 6G60 (I6/v6.32 lib 6/12N) SD

Capitol Square West
You are standing on the Capitol Square in Madison. It is a sunny August morning. Madison Ruby is about to begin.

Ahead, to the west, is the bustling pedestrian mall of State Street. Towering behind you is the white-domed Capitol Building.

There is a helpful walking map.

>go building
You can't see any such thing.

>lo
That's not a verb I recognise.

>l
Capitol Square
You are standing on the Capitol Square in Madison. It is a sunny August morning. Ahead, to the west, is the bustling pedestrian mall of State Street. Towering behind you is the white-domed Capitol Building.

>e
'Capitol Building'
The Capitol Building looms above you. The doors are locked.

>w
Capitol Square
You are standing on the Capitol Square in Madison. It is a sunny August morning. Ahead, to the west, is the bustling pedestrian mall of State Street. Towering behind you is the white-domed Capitol Building.

* * *

madison_ruby
An Interactive Fiction by Chris Wilson
Release 1 / Serial number 120802 / Inform 7 build 6G60 (I6/v6.32 lib 6/12N) SD

Capitol Square West
You are standing on the Capitol Square in Madison. It is a sunny August morning. Madison Ruby is about to begin.

Ahead, to the west, is the bustling pedestrian mall of State Street. Towering behind you is the white-domed Capitol Building.

There is a helpful walking map.

>look cap
You can't see any such thing.

>look capitol building
You can't see any such thing.

* * *

madison_ruby
An Interactive Fiction by Chris Wilson
Release 1 / Serial number 120802 / Inform 7 build 6G60 (I6/v6.32 lib 6/12N) SD

Capitol Square West
You are standing on the Capitol Square in Madison. It is a sunny August morning. Madison Ruby is about to begin.

Ahead, to the west, is the bustling pedestrian mall of State Street. Towering behind you is the white-domed Capitol Building.

There is a helpful walking map.

>look
Capitol Square West
You are standing on the Capitol Square in Madison. It is a sunny August morning. Ahead, to the west, is the bustling pedestrian mall of State Street. Towering behind you is the white-domed Capitol Building.

>w
'State Street Entrance'

* * *

>look
Capitol Square West
You are standing on the Capitol Square in Madison. It is a sunny August morning. Ahead, to the west, is the bustling pedestrian mall of State Street. Towering behind you is the white-domed Capitol Building.

>e
'Capitol Building'
Towering behind you is the white-domed Capitol Building.

* * *

>look
Capitol Square West
You are standing on the Capitol Square in Madison. It is a sunny August morning. Ahead, to the west, is the bustling pedestrian mall of State Street. Towering behind you is the white-domed Capitol Building.

>take map
You can't see any such thing.

* * *

madison_ruby
An Interactive Fiction by Chris Wilson
Release 1 / Serial number 120802 / Inform 7 build 6G60 (I6/v6.32 lib 6/12N) SD

Capitol Square West
You are standing on the Capitol Square in Madison. It is a sunny August morning. Madison Ruby is about to begin.

Ahead, to the west, is the bustling pedestrian mall of State Street. Towering behind you is the white-domed Capitol Building.

There is a helpful walking map.

>w
State Street Entrance
You are standing on the first block of State Street. The commotion of people beginning their day surrounds you.

>w
You can't go that way.

>look
State Street Entrance
You are standing on the first block of State Street. The commotion of people beginning their day surrounds you.

>look
State Street Entrance
You are standing on the first block of State Street. The commotion of people beginning their day surrounds you.

>w
You can't go that way.

>e
Capitol Square West
You are standing on the Capitol Square in Madison. It is a sunny August morning. Madison Ruby is about to begin.

Ahead, to the west, is the bustling pedestrian mall of State Street. Towering behind you is the white-domed Capitol Building.

>look
Capitol Square West
You are standing on the Capitol Square in Madison. It is a sunny August morning. Madison Ruby is about to begin.

Ahead, to the west, is the bustling pedestrian mall of State Street. Towering behind you is the white-domed Capitol Building.

* * *

madison_ruby
An Interactive Fiction by Chris Wilson
Release 1 / Serial number 120802 / Inform 7 build 6G60 (I6/v6.32 lib 6/12N) SD

Capitol Square West
You are standing on the Capitol Square in Madison. It is a sunny August morning. Madison Ruby is about to begin.

Ahead, to the west, is the bustling pedestrian mall of State Street. Towering behind you is the white-domed Capitol Building.

There is a helpful walking map.

>look Capitol Building
You can't see any such thing.