MadisonRuby2012
An Interactive Fiction by Chris Wilson
Release 1 / Serial number 120802 / Inform 7 build 6G60 (I6/v6.32 lib 6/12N) SD

Capitol Square West
You are standing on the Capitol Square in Madison. Near you there is a statue of a woman with her arm outstretched.

West is the bustling pedestrian mall of State Street. East is the white-domed Capitol Building.

There is a statue of a woman with her arm outstretched.

On the statue is a plaque.

>look plaque
The plaque reads "FORWARD Wisconsin Womens Memorial of the Columbian Exposition -1893-.

* * *

MadisonRuby2012
An Interactive Fiction by Chris Wilson
Release 1 / Serial number 120802 / Inform 7 build 6G60 (I6/v6.32 lib 6/12N) SD

Capitol Square West
You are standing on the Capitol Square in Madison. Near you there is a statue of a woman with her arm outstretched.

West is the bustling pedestrian mall of State Street. East is the white-domed Capitol Building.

There is a statue of a woman with her arm outstretched.

On the statue is a plaque.

>read plaque
You see nothing special about the plaque.

>look plaque
You see nothing special about the plaque.

>look statue
On the statue is a plaque.

>look on statue
You can't see any such thing.

>look statue
On the statue is a plaque.

>look at plaque on statue
You can't see any such thing.

* * *

MadisonRuby2012
An Interactive Fiction by Chris Wilson
Release 1 / Serial number 120802 / Inform 7 build 6G60 (I6/v6.32 lib 6/12N) SD

Capitol Square West
You are standing on the Capitol Square in Madison. Near you there is a statue of a woman with her arm outstretched.

West is the bustling pedestrian mall of State Street. East is the white-domed Capitol Building.

There is a statue of a woman with her arm outstretched.

On the statue is a plaque.

>i
You are carrying:
  a wallet
    5 dollars
  a watch (being worn)
  a driver's license

>i
You are carrying:
  a wallet
    5 dollars
  a driver's license

>look driver
You can't see any such thing.

>look driver's license
You see nothing special about the driver's license.

* * *

>i
You are carrying:
  a wallet
    5 dollars
  a watch (being worn)
  a driver's license

>take wallet
You can't see any such thing.

* * *

>i
You are carrying:
  a wallet
    5 dollars
  a watch (being worn)
  a driver's license

>drink coffee
You drink the coffee. Things are much better.

* * *

>i
You are carrying:
  a wallet
    5 dollars
  a watch (being worn)
  a driver's license

>look driver's license
You see nothing special about the driver's license.

>equip driver's license
That's not a verb I recognise.

>use driver's license
That's not a verb I recognise.

>describe driver's license
You see nothing special about the driver's license.

* * *

>look driver's license
You see nothing special about the driver's license.

>examine driver's license
You see nothing special about the driver's license.

>take driver's license
You already have that.

>look at driver's license
You see nothing special about the driver's license.

>i
You are carrying:
  a wallet
    5 dollars
  a driver's license

>i driver's license
I only understood you as far as wanting to take inventory.

>i
You are carrying:
  a wallet
    5 dollars
  a driver's license

* * *

You seem to want to talk to someone, but I can't see whom.

>inspect a driver's license
That's not a verb I recognise.

>look at a driver's license
You see nothing special about the driver's license.

>look at driver's license
You see nothing special about the driver's license.

* * *

MadisonRuby2012
An Interactive Fiction by Chris Wilson
Release 1 / Serial number 120802 / Inform 7 build 6G60 (I6/v6.32 lib 6/12N) SD

Capitol Square West
You are standing on the Capitol Square in Madison. Near you there is a statue of a woman with her arm outstretched.

West is the bustling pedestrian mall of State Street. East is the white-domed Capitol Building.

There is a statue of a woman with her arm outstretched.

On the statue is a plaque.

>time
That's not a verb I recognise.

>what time is it
That's not a verb I recognise.

>what time is it?
That's not a verb I recognise.

>check time?
You can't see any such thing.

* * *

MadisonRuby2012
An Interactive Fiction by Chris Wilson
Release 1 / Serial number 120802 / Inform 7 build 6G60 (I6/v6.32 lib 6/12N) SD

Capitol Square West
You are standing on the Capitol Square in Madison. Near you there is a statue of a woman with her arm outstretched.

West is the bustling pedestrian mall of State Street. East is the white-domed Capitol Building.

There is a statue of a woman with her arm outstretched.

On the statue is a plaque.

>look
Capitol Square West
You are standing on the Capitol Square in Madison. It is a sunny August morning. Near you there is a statue of a woman with her arm outstretched. 

West is the bustling pedestrian mall of State Street. East is the white-domed Capitol Building.

* * *

MadisonRuby2012
An Interactive Fiction by Chris Wilson
Release 1 / Serial number 120802 / Inform 7 build 6G60 (I6/v6.32 lib 6/12N) SD

Capitol Square West
You are standing on the Capitol Square in Madison. Near you there is a statue of a woman with her arm outstretched.

West is the bustling pedestrian mall of State Street. East is the white-domed Capitol Building.

There is a statue of a woman with her arm outstretched.

On the statue is a plaque.

>w
State Street Entrance
You are standing on the first block of State Street. The commotion of people beginning their day surrounds you. 

There is a helpful walking map.

>w
Outside the Overture Center
The Overture Center for the Performing Arts is a white and glassy edifice that stretches for the whole block. On the State Street side the windows contain advertisements for upcoming plays and musicals. There are heavy glass doors at the entrance.

* * *

>w
State Street Entrance
You are standing on the first block of State Street. The commotion of people beginning their day surrounds you. 

There is a helpful walking map.

>n
Espresso Royale
Espresso Royale is filled with early morning coffee people, which is to say normal people.

You can see a barista here.

>n
You can't go that way.

* * *

>n
Espresso Royale
Espresso Royale is filled with early morning coffee people, which is to say normal people.

You can see a barista here.

>l
Espresso Royale
Espresso Royale is filled with early morning coffee people, which is to say normal people.

* * *

>n
Espresso Royale
Espresso Royale is filled with early morning coffee people, which is to say normal people.

You can see a barista here.

>look barista
You see nothing special about the barista.

>take apron
That seems to belong to the barista.

>give wallet
You can't see any such thing.

* * *

>look barista
You see nothing special about the barista.

>take coffee
That seems to belong to the barista.

>look coffee
You see nothing special about the coffee.

* * *

>w
State Street Entrance
You are standing on the first block of State Street. The commotion of people beginning their day surrounds you. 

There is a helpful walking map.

>e
Capitol Square West
You are standing on the Capitol Square in Madison. It is a sunny August morning. Near you there is a statue of a woman with her arm outstretched. 

West is the bustling pedestrian mall of State Street. East is the white-domed Capitol Building.

There is a statue of a woman with her arm outstretched.

On the statue is a plaque.

>w
State Street Entrance
The first block of State Street also has a bunch of restaurants on it. Of note to the groggy Rubyist, is the "Espresso Royale Cafe" on the north side of the street.

There is a helpful walking map.

* * *

>w
State Street Entrance
You are standing on the first block of State Street. The commotion of people beginning their day surrounds you. 

There is a helpful walking map.

>look map
The map indicates that, duh, the Capitol is up State Street. The map also shows that the Overture Center is down state street, one block west.

* * *

MadisonRuby2012
An Interactive Fiction by Chris Wilson
Release 1 / Serial number 120802 / Inform 7 build 6G60 (I6/v6.32 lib 6/12N) SD

Capitol Square West
You are standing on the Capitol Square in Madison. Near you there is a statue of a woman with her arm outstretched.

West is the bustling pedestrian mall of State Street. East is the white-domed Capitol Building.

There is a statue of a woman with her arm outstretched.

On the statue is a plaque.

>take plaque
That's fixed in place.

>look
Capitol Square West
You are standing on the Capitol Square in Madison. It is a sunny August morning. Near you there is a statue of a woman with her arm outstretched. 

West is the bustling pedestrian mall of State Street. East is the white-domed Capitol Building.

A statue of a woman with her arm outstretched.

On the statue is a plaque.

>look at the plaque
You see nothing special about the plaque.

>read the plaque
You see nothing special about the plaque.

>examine plaque
You see nothing special about the plaque.

>examine statue
On the statue is a plaque.

>look plaque
You see nothing special about the plaque.

>go statue
That's not something you can enter.

>touch statue
You feel nothing unexpected.

>take statue
That's fixed in place.

* * *

MadisonRuby2012
An Interactive Fiction by Chris Wilson
Release 1 / Serial number 120802 / Inform 7 build 6G60 (I6/v6.32 lib 6/12N) SD

Capitol Square West
You are standing on the Capitol Square in Madison. Near you there is a statue of a woman with her arm outstretched.

West is the bustling pedestrian mall of State Street. East is the white-domed Capitol Building.

There is a statue of a woman with her arm outstretched.

On the statue is a plaque.

>look statue
On the statue is a plaque.

>look pla
You can't see any such thing.

>look plaque
The plaque reads "FORWARD Wisconsin Womens Memorial of the Columbian Exposition -1893-."

>w
State Street Entrance
You are standing on the first block of State Street. The commotion of people beginning their day surrounds you.

There is a helpful walking map.